111111111111111111111111111111111111111111111111111111111111111
100000000000000100001100000000000000100001100000000000000100001
1000000000000000C00000000000000000000C00000000000000000000C0001
100000000000001111001100000000000001111001100000000000001111001
100000000C000011C0011100000000C000011C0011100000000C000011C0011
100000000000000101111100000000000000101111100000000000000101111
100C0000C0000001000C1100C0000C0000001000C1100C0000C0000001000C1
1000000C0C000001111E11000000C0C000001111011000000C0C00000111101
111111111111111111111111111101111111111111111111111111111111111
111111111111111111111111111101111111111111111111111111111111111
100000000000000100000000000000000000100001100000000000000100001
1P00000000000000C0001100000000000000100001100000000000000100001
100000000000001111001100000000000000100001100000000000000100001
100000000C000011C0011100000000000000100001100000000000000100001
100000000000000101111100000000000000100001100000000000000100001
100C0000C0000001000C1100000000000000100001100000000000000100001
1000000C0C00000111101100000000000000100001100000000000000100001
111111111111111111111100000000000000100001100000000000000100001
111111111111111111111100000000000000100001100000000000000100001
100000000000000100000000000000000000000000000000000000000000001
100000000000000C00011000000000000001000011000000000000001000001
100000000000001111001100000000000000100001100000000000000100001
100000000C000011C0011100000000000000100001100000000000000100001
100000000000000101111100000000000000100001100000000000000100001
100C0000C0000001000C1100000000000000100001100000000000000100001
1000000C0C00000111101100000000000000100001100000000000000100001
111111111111111111111111111111111111111111111111111111111111111