1111111111111111111111111111111111111111
1000000000000000000000000000000000000001
1011111111100001111111111111111111111101
1011111111P00C0E111111111111111111111101
1011111111111111111111111111111111111101
1011111111111111111111111111111111111101
1011111111111111111111111111111111111101
1011111111111111111111111111111111111101
1011111111111111111111111111111111111101
1011111111111111111111111111111111111101
1011111111111111111111111111111111111101
1011111111111111111111111111111111111101
1011111111111111111111111111111111111101
1011111111111111111111111111111111111101
1011111111111111111111111111111111111101
1011111111111111111111111111111111111101
1011111111111111111111111111111111111101
1011111111111111111111111111111111111101
1011111111111111111111111111111111111101
1011111111111111111111111111111111111101
1000000000000000000000000000000000000001
1111111111111111111111111111111111111111