11111111111111111111111111
1000PCE00000000C0000000001
11111111111111111111111111