11111111111111111111
1GS0000000P000000001
10000000000000SG0001
1000SSSSSSSSS0000001
1G0CCCCCCCCC000000E1
11111111111111111111