11111111111111111111
1GS0000000P000000001
100000000000000G0001
10000000000000000001
1G0CCCCCCCCC000000E1
11111111111111111111